t1 -- t4 t5 t6 -- --
t2 -- -- -- -- -- --
t3 -- t1 -- -- -- --
-- -- t2 MS -- -- --
t1 -- t3 -- -- -- --
t2 -- -- -- -- -- --
t3 -- t4 t5 t5 t6 --